######################################
# P                                  #
# XXXXXXXXXXXXXXXXXXXXXXXXXXXXXXXXX  #
# OOOOOOOOOOOOOOOOOOOOOOOOOOOOOOOOO  #
#                                    #
# XXXXXXXXXXXXXXXXXXXXXXXXXXXXXXXXX  #
# OOOOOOOOOOOOOOOOOOOOOOOOOOOOOOOOO  #
#                                    #
# XXXXXXXXXXXXXXXXXXXXXXXXXXXXXXXXX  #
# OOOOOOOOOOOOOOOOOOOOOOOOOOOOOOOOO  #
######################################