##############
#            ####
#               ###
#     P           ###############
#                               #
#                               #
#                               #
##########################      #
                         #      #
                        #       #
                       #        #
                      #   OX    #
                      ###########