###########
# XP    X #
#         #
#   OOO   #
#    O    #
#         ##
# X      X #
############