########
#   O  #
#   X  #
#   P  #
#      #
#      #
#      #
########